1:3 1:0 1:0 1:0 1:0 1:0 1:0 1:0 1:0 1:0 1:0 1:0 1:0 1:0 1:0 1:0 1:8 1:0 1:0 1:0 1:0 1:0 1:0 1:8 1:0 1:0 1:0 1:0 1:4 0 0 
1:1 2:0:0 2:0:0 2:0:0 2:0:0 2:0:0 2:0:0 2:0:0 2:0:0 2:0:0 2:0:0 2:0:0 2:0:0 2:0:0 2:0:0 2:0:0 1:1 2:1:0 2:0:0 2:0:0 2:0:0 2:0:0 2:0:0 1:12 2:0:0 2:0:0 2:0:0 2:0:0 1:5 1:0 1:4 
1:1 2:0:0 1:13 1:0 1:0 1:0 1:0 1:0 1:0 1:0 1:0 1:0 1:0 1:4 2:0:0 1:13 1:2 2:0:0 1:3 1:0 1:0 1:4 2:0:0 2:0:0 2:0:0 1:3 1:4 2:0:0 2:0:0 2:0:0 1:1 
1:1 2:0:0 2:0:0 2:0:0 2:0:0 2:0:0 2:0:0 2:0:0 2:0:0 2:0:0 2:0:0 2:0:0 2:0:0 1:1 2:0:0 2:0:0 2:0:0 2:0:0 1:1 0 0 1:5 1:0 1:0 1:0 1:2 1:5 1:0 1:4 2:0:0 1:1 
1:1 2:0:0 1:10 3:1 1:3 1:0 1:0 1:0 1:0 1:0 1:0 1:4 2:0:0 1:5 1:0 1:0 1:0 1:8 1:9 0 0 0 0 0 0 0 0 0 1:1 2:0:0 1:1 
1:1 2:0:0 1:5 1:0 1:2 2:0:0 2:0:0 2:0:0 2:0:0 2:0:0 2:0:0 1:1 2:0:0 2:0:0 2:0:0 2:0:0 2:0:0 1:5 1:6 1:0 1:0 1:0 1:0 1:0 1:0 1:0 1:0 1:0 1:2 2:0:0 1:1 
1:1 2:1:0 2:0:0 2:0:0 2:0:0 2:0:0 1:3 1:0 1:0 1:4 2:0:0 1:7 1:0 1:0 1:0 1:4 2:0:0 2:0:0 2:0:0 2:0:0 2:0:0 2:0:0 2:0:0 2:0:0 2:0:0 2:0:0 2:0:0 2:0:0 2:0:0 2:1:0 1:1 
1:7 1:0 1:0 1:0 1:0 1:0 1:2 0 0 1:1 2:0:0 1:1 0 0 0 1:5 1:4 2:0:0 1:3 1:0 1:0 1:0 1:0 1:0 1:0 1:0 1:0 1:0 1:0 1:0 1:2 
1:1 2:1:0 2:0:0 2:0:0 2:0:0 1:10 0 0 0 1:1 2:0:0 1:1 0 0 0 0 1:1 2:0:0 1:1 0 0 0 0 0 0 0 0 0 0 0 0 
1:1 2:0:0 1:3 1:4 2:0:0 1:1 0 0 0 1:1 2:0:0 1:1 0 0 0 0 1:1 2:0:0 1:1 0 0 0 0 0 0 0 0 0 0 0 0 
1:1 2:0:0 1:1 1:1 2:0:0 1:1 0 0 0 1:1 2:0:0 1:5 1:0 1:0 1:0 1:0 1:2 2:0:0 1:5 1:0 1:0 1:0 1:0 1:0 1:0 1:0 1:0 1:0 1:0 1:0 1:4 
1:1 2:0:0 1:1 1:1 2:0:0 1:5 1:0 1:0 1:0 1:2 2:0:0 2:0:0 2:0:0 2:0:0 2:0:0 2:0:0 2:0:0 2:1:0 2:0:0 2:0:0 2:0:0 2:0:0 2:0:0 2:0:0 2:0:0 2:0:0 2:0:0 2:0:0 2:0:0 2:1:0 1:1 
1:1 2:0:0 1:1 1:1 2:0:0 2:0:0 2:0:0 2:0:0 2:0:0 2:0:0 2:2:0 1:3 1:0 1:0 1:0 1:0 1:4 2:0:0 1:3 1:0 1:0 1:0 1:11 4:3 1:13 1:0 1:0 1:0 1:4 2:0:0 1:1 
1:1 2:0:0 1:1 1:5 1:0 1:0 1:0 1:0 1:0 1:0 1:0 1:2 0 0 0 0 1:1 2:0:0 1:1 0 0 0 1:10 4:2 1:10 0 0 0 1:1 2:0:0 1:1 
1:1 2:0:0 1:1 0 0 0 0 0 0 0 0 0 0 0 0 0 1:1 2:0:0 1:1 0 0 0 1:1 4:1 1:1 0 0 0 1:1 2:0:0 1:1 
1:1 2:0:0 1:1 0 0 0 0 0 0 0 0 0 0 0 0 0 1:1 2:0:0 1:1 0 0 0 1:12 4:0 1:12 0 0 0 1:1 2:0:0 1:1 
1:1 2:0:0 1:1 0 0 0 0 0 0 0 0 0 0 0 0 0 1:1 2:0:0 1:5 1:0 1:0 1:0 1:0 1:0 1:4 0 0 0 1:1 2:0:0 1:1 
1:1 2:0:0 1:1 0 0 0 0 0 0 0 0 0 0 0 0 0 1:1 2:0:0 2:0:0 2:0:0 2:0:0 2:0:0 2:0:0 2:1:0 1:1 0 0 1:3 1:2 2:0:0 1:1 
1:1 2:0:0 1:1 0 0 0 0 0 0 0 0 0 0 0 0 0 1:5 1:0 1:0 1:0 1:0 1:0 1:4 2:0:0 1:1 0 0 1:1 2:0:0 2:0:0 1:1 
1:1 2:0:0 1:1 0 0 0 0 0 0 0 0 0 0 0 0 0 1:10 2:0:0 2:2:0 2:0:0 1:10 0 1:1 2:0:0 1:1 0 0 1:1 2:0:0 1:13 1:9 
1:1 2:0:0 1:1 0 0 0 0 0 0 0 0 0 0 0 0 0 1:1 2:0:0 1:10 2:0:0 1:1 0 1:1 2:0:0 1:1 0 0 1:1 2:0:0 2:0:0 1:1 
1:1 2:0:0 1:1 0 0 0 0 0 0 0 0 0 0 0 0 0 1:1 2:0:0 1:1 2:0:0 1:1 0 1:1 2:0:0 1:1 0 0 1:7 1:11 2:0:0 1:1 
1:1 2:0:0 1:1 0 0 0 0 0 0 0 0 0 0 0 0 0 1:1 2:0:0 1:1 2:0:0 1:1 0 1:1 2:0:0 1:1 0 0 1:5 1:4 2:0:0 1:1 
1:1 2:0:0 1:1 0 0 0 0 0 0 0 0 0 0 0 0 0 1:1 2:0:0 1:1 2:0:0 1:1 0 1:1 2:0:0 1:1 0 0 0 1:1 2:0:0 1:1 
1:1 2:0:0 1:1 0 0 0 0 0 0 0 0 0 0 0 0 0 1:1 2:0:0 1:1 2:0:0 1:1 0 1:1 2:0:0 1:1 0 0 0 1:1 2:0:0 1:1 
1:1 2:0:0 1:1 0 0 0 0 0 0 0 0 0 0 0 0 0 1:1 2:0:0 1:1 2:0:0 1:1 0 1:1 2:0:0 1:1 0 0 0 1:1 2:0:0 1:1 
1:1 2:0:0 1:1 0 0 0 0 0 0 0 0 0 0 0 0 0 1:1 2:0:0 1:1 2:0:0 1:1 0 1:1 2:0:0 1:1 0 0 0 1:1 2:0:0 1:1 
1:1 2:0:0 1:1 0 0 0 0 0 0 0 0 0 0 0 0 0 1:1 2:0:0 1:1 2:0:0 1:5 1:0 1:2 2:0:0 1:1 0 0 0 1:1 2:0:0 1:1 
1:1 2:0:0 1:5 1:0 1:0 1:0 1:0 1:0 1:0 1:0 1:0 1:0 1:0 1:0 1:0 1:0 1:2 2:0:0 1:1 2:0:0 2:0:0 2:0:0 2:0:0 2:1:0 1:5 1:0 1:0 1:0 1:2 2:0:0 1:1 
1:1 2:1:0 2:0:0 2:0:0 2:0:0 2:0:0 2:0:0 2:0:0 2:0:0 2:0:0 2:0:0 2:0:0 2:0:0 2:0:0 2:0:0 2:0:0 2:0:0 2:1:0 1:1 1:10 1:10 1:10 1:10 2:0:0 2:0:0 2:0:0 2:0:0 2:0:0 2:0:0 2:0:0 1:1 
1:5 1:0 1:0 1:0 1:0 1:0 1:0 1:0 1:0 1:0 1:0 1:0 1:0 1:0 1:0 1:0 1:0 1:0 1:6 1:6 1:6 1:6 1:6 1:0 1:0 1:0 1:0 1:0 1:0 1:0 1:2 
