1:3 1:0 1:0 1:0 1:0 1:0 1:0 1:0 1:0 1:0 1:0 1:0 1:0 1:0 1:0 1:0 1:0 1:0 1:0 1:0 1:0 1:0 1:0 1:0 1:0 1:0 1:0 1:0 1:0 1:0 1:4 
1:1 3:1 2:9 2:9 2:9 2:8 2:9 2:0 2:9 2:9 2:9 2:9 2:2 2:9 2:9 2:9 2:9 2:9 2:9 2:9 2:9 2:9 2:9 2:9 2:9 2:9 2:9 2:9 2:9 2:0 1:1 
1:1 2:9 1:3 1:0 1:0 1:0 1:0 1:0 1:0 1:0 1:0 1:0 1:0 1:0 1:0 1:0 1:0 1:0 1:0 1:0 1:0 1:0 1:0 1:0 1:0 1:0 1:0 1:0 1:4 2:9 1:1 
1:1 2:9 1:1 0 0 0 0 0 0 0 0 0 0 0 0 0 0 0 0 0 0 0 0 0 0 0 0 0 1:1 2:9 1:1 
1:1 2:9 1:1 0 0 0 0 0 0 0 0 0 0 0 0 0 0 0 0 0 0 0 0 0 0 0 0 0 1:1 2:9 1:1 
1:1 2:9 1:1 0 0 0 0 0 0 0 0 0 0 0 0 0 0 0 0 0 0 0 0 0 0 0 0 0 1:1 2:9 1:1 
1:1 2:9 1:1 0 0 0 0 0 0 0 0 0 0 0 0 0 0 0 0 0 0 0 0 0 0 0 0 0 1:1 2:9 1:1 
1:1 2:0 1:1 0 0 0 0 0 0 0 0 0 0 0 0 0 0 0 0 0 0 0 0 0 0 0 0 0 1:1 2:9 1:1 
1:1 2:9 1:1 0 0 0 0 0 0 0 0 0 0 0 0 0 0 0 0 0 0 0 0 0 0 0 0 0 1:1 2:9 1:1 
1:1 2:9 1:1 0 0 0 0 0 0 0 0 0 0 0 0 0 0 0 0 0 0 0 0 0 0 0 0 0 1:1 2:9 1:1 
1:1 2:9 1:1 0 0 0 0 0 0 0 0 0 0 0 0 0 0 0 0 0 0 0 0 0 0 0 0 0 1:1 2:9 1:1 
1:1 2:9 1:1 0 0 0 0 0 0 0 0 0 0 0 0 0 0 0 0 0 0 0 0 0 0 0 0 0 1:1 2:9 1:1 
1:1 2:9 1:1 0 0 0 0 0 0 0 0 0 0 0 0 0 0 0 0 0 0 0 0 0 0 0 0 0 1:1 2:9 1:1 
1:1 2:9 1:1 0 0 0 0 0 0 0 0 0 0 0 0 0 0 0 0 0 0 0 0 0 0 0 0 0 1:1 2:9 1:1 
1:1 2:9 1:1 0 0 0 0 0 0 0 0 0 0 0 0 0 0 0 0 0 0 0 0 0 0 0 0 0 1:1 2:9 1:1 
1:1 2:9 1:1 0 0 0 0 0 0 0 0 0 0 0 0 0 0 0 0 0 0 0 0 0 0 0 0 0 1:1 2:9 1:1 
1:1 2:9 1:1 0 0 0 0 0 0 0 0 0 0 0 0 0 0 0 0 0 0 0 0 0 0 0 0 0 1:1 2:9 1:1 
1:1 2:9 1:1 0 0 0 0 0 0 0 0 0 0 0 0 0 0 0 0 0 0 0 0 0 0 0 0 0 1:1 2:9 1:1 
1:1 2:9 1:1 0 0 0 0 0 0 0 0 0 0 0 0 0 0 0 0 0 0 0 0 0 0 0 0 0 1:1 2:9 1:1 
1:1 2:9 1:1 0 0 0 0 0 0 0 0 0 0 0 0 0 0 0 0 0 0 0 0 0 0 0 0 0 1:1 2:9 1:1 
1:1 2:9 1:1 0 0 0 0 0 0 0 0 0 0 0 0 0 0 0 0 0 0 0 0 0 0 0 0 0 1:1 2:9 1:1 
1:1 2:0 1:1 0 0 0 0 0 0 0 0 0 0 0 0 0 0 0 0 0 0 0 0 0 0 0 0 0 1:1 2:9 1:1 
1:1 2:9 1:1 0 0 0 0 0 0 0 0 0 0 0 0 0 0 0 0 0 0 0 0 0 0 0 0 0 1:1 2:9 1:1 
1:1 2:9 1:1 0 0 0 0 0 0 0 0 0 0 0 0 0 0 0 0 0 0 0 0 0 0 0 0 0 1:1 2:9 1:1 
1:1 2:9 1:1 0 0 0 0 0 0 0 0 0 0 0 0 0 0 0 0 0 0 0 0 0 0 0 0 0 1:1 2:9 1:1 
1:1 2:9 1:1 0 0 0 0 0 0 0 0 1:3 1:0 1:0 1:0 1:4 0 0 0 0 0 0 0 0 0 0 0 0 1:1 2:9 1:1 
1:1 2:9 1:1 0 0 0 0 0 0 0 0 1:1 4:0 4:1 4:2 1:1 0 0 0 0 0 0 0 0 0 0 0 0 1:1 2:9 1:1 
1:1 2:9 1:1 0 0 0 0 0 0 0 0 1:5 1:4 4:3 1:3 1:2 0 0 0 0 0 0 0 0 0 0 0 0 1:1 2:9 1:1 
1:1 2:9 1:5 1:0 1:0 1:0 1:0 1:0 1:0 1:0 1:0 1:0 1:2 0 1:5 1:0 1:0 1:0 1:0 1:0 1:0 1:0 1:0 1:0 1:0 1:0 1:0 1:0 1:2 2:9 1:1 
1:1 2:0 2:9 2:9 2:9 2:9 2:9 2:9 2:9 2:9 2:9 2:9 2:9 2:9 2:9 2:9 2:9 2:9 2:9 2:9 2:9 2:9 2:9 2:9 2:9 2:9 2:9 2:9 2:9 2:9 1:1 
1:5 1:0 1:0 1:0 1:0 1:0 1:0 1:0 1:0 1:0 1:0 1:0 1:0 1:0 1:0 1:0 1:0 1:0 1:0 1:0 1:0 1:0 1:0 1:0 1:0 1:0 1:0 1:0 1:0 1:0 1:2 
