1:3 1:0 1:4 0 0 0 0 0 0 0 0 0 0 0 0 0 0 0 0 0 0 0 0 0 1:3 1:0 1:0 1:0 1:0 1:0 1:4 
1:1 2:0 1:5 1:0 1:0 1:0 1:0 1:0 1:0 1:0 1:0 1:0 1:0 1:0 1:0 1:0 1:0 1:0 1:0 1:0 1:0 1:0 1:0 1:0 1:2 2:9 2:9 2:9 2:9 2:0 1:1 
1:1 2:9 2:9 2:9 2:9 2:1 2:9 2:9 2:9 2:9 2:9 2:9 2:9 2:9 2:9 2:9 2:9 2:9 2:9 2:9 2:2 2:9 2:9 2:9 2:9 2:9 1:3 1:0 1:4 2:9 1:1 
1:1 2:9 1:3 1:0 1:4 2:9 1:3 1:0 1:0 1:0 1:0 1:4 2:9 1:3 1:0 1:0 1:0 1:0 1:0 1:4 2:9 1:3 1:0 1:0 1:4 2:9 1:1 0 1:1 2:9 1:1 
1:1 2:9 1:1 0 1:1 2:9 1:1 0 0 0 0 1:1 2:9 1:1 0 0 0 0 0 1:1 2:9 1:1 0 0 1:1 2:9 1:1 0 1:1 2:9 1:1 
1:1 2:9 1:1 0 1:1 2:9 1:1 0 0 0 0 1:1 2:9 1:1 0 0 0 0 0 1:1 2:9 1:1 0 0 1:1 2:9 1:1 0 1:1 2:9 1:1 
1:1 2:9 1:1 0 1:1 2:9 1:1 0 0 0 0 1:1 2:9 1:1 0 0 0 0 0 1:1 2:9 1:1 0 0 1:1 2:9 1:1 0 1:1 2:9 1:1 
1:1 2:9 1:1 0 1:1 2:9 1:5 1:0 1:0 1:0 1:0 1:2 2:9 1:5 1:0 1:0 1:0 1:0 1:0 1:2 2:9 1:1 0 0 1:1 2:9 1:5 1:11 1:12 2:9 1:1 
1:1 2:9 1:1 0 1:1 2:9 2:9 2:9 2:9 2:9 2:9 2:9 2:9 2:9 2:9 2:9 2:9 2:9 2:9 2:9 2:9 1:5 1:0 1:0 1:2 2:9 2:9 2:9 2:9 2:9 1:1 
1:1 2:9 1:5 1:0 1:2 2:9 1:3 1:0 1:0 1:0 1:0 1:4 0 1:3 1:0 1:0 1:0 1:0 1:0 1:4 2:2 2:9 2:9 2:9 2:9 2:9 1:3 1:0 1:11 2:9 1:1 
1:1 2:1 2:9 2:9 2:9 2:9 1:1 0 0 0 1:3 1:2 0 1:5 1:4 1:13 1:0 1:0 1:11 1:5 1:0 1:0 1:0 1:0 1:0 1:0 1:2 0 0 2:9 1:1 
1:5 1:0 1:0 1:0 1:4 2:9 1:1 0 0 0 1:1 4:1 4:2 4:3 1:1 0 0 0 0 0 0 0 0 0 0 0 0 0 1:10 2:9 1:1 
0 0 0 0 1:1 2:9 1:1 0 0 0 1:5 1:11 4:0 1:13 1:2 2:8 1:3 1:0 1:0 1:0 1:0 1:0 1:0 1:0 1:0 1:0 1:0 1:4 1:1 2:9 1:1 
1:0 1:0 1:0 1:0 1:2 2:9 1:5 1:0 1:0 1:0 1:0 1:11 0 1:13 1:0 1:0 1:2 2:0 2:9 2:9 2:9 2:9 2:9 2:9 2:9 2:9 1:13 1:6 1:2 2:9 1:5 
2:9 2:9 2:9 2:9 2:9 2:0 2:9 2:9 2:9 2:9 2:9 2:9 2:9 2:9 2:9 2:9 2:9 2:9 1:3 1:0 1:0 1:0 1:8 1:0 1:4 2:9 2:9 2:9 2:9 2:9 2:9 
1:0 1:0 1:0 1:0 1:4 2:9 1:3 1:0 1:4 2:9 1:3 1:0 1:4 2:9 1:3 1:0 1:4 2:9 1:1 0 0 0 1:1 2:9 1:5 1:11 2:9 1:13 1:0 1:0 1:4 
0 0 0 0 1:1 2:9 1:1 0 1:1 2:9 1:1 0 1:1 2:9 1:1 0 1:1 2:9 1:1 0 0 0 1:1 2:9 2:9 2:9 2:9 2:9 2:9 2:1 1:1 
1:3 1:0 1:0 1:0 1:2 2:9 1:1 0 1:1 2:9 1:1 0 1:1 2:9 1:1 0 1:1 2:9 1:1 0 0 0 1:1 2:9 1:3 1:0 1:0 1:0 1:4 2:9 1:1 
1:1 2:2 2:9 2:9 2:9 2:9 1:1 0 1:1 2:9 1:1 0 1:1 2:9 1:1 0 1:1 2:9 1:1 0 0 0 1:1 2:9 1:1 0 0 0 1:1 2:9 1:1 
1:1 2:9 1:3 1:0 1:0 1:0 1:2 0 1:1 2:9 1:1 0 1:1 2:9 1:1 0 1:1 2:9 1:1 0 0 0 1:1 2:9 1:1 0 0 0 1:1 2:9 1:1 
1:1 2:9 1:1 0 0 0 0 0 1:1 2:9 1:1 0 1:1 2:9 1:1 0 1:1 2:9 1:1 0 0 0 1:1 2:9 1:1 0 0 0 1:1 2:9 1:1 
1:1 2:9 1:5 1:0 1:0 1:0 1:0 1:0 1:2 2:9 1:1 0 1:1 2:9 1:1 0 1:1 2:9 1:1 0 0 0 1:1 2:9 1:1 0 0 0 1:1 2:9 1:1 
1:1 2:9 2:9 2:9 2:9 2:9 2:9 2:9 2:9 2:2 1:1 0 1:1 2:9 1:1 0 1:1 2:9 1:1 0 0 0 1:1 2:9 1:1 0 0 0 1:1 2:9 1:1 
1:1 2:9 1:3 1:0 1:0 1:0 1:0 1:0 1:4 2:9 1:5 1:0 1:2 2:9 1:5 1:0 1:2 2:9 1:5 1:0 1:4 0 1:1 2:9 1:1 0 0 0 1:1 2:9 1:1 
1:1 2:9 1:1 0 0 0 0 0 1:1 2:9 2:9 2:9 2:9 3:0 2:9 2:9 2:9 2:9 2:9 2:9 1:1 0 1:1 2:9 1:1 0 0 0 1:1 2:9 1:1 
1:1 2:9 1:5 1:0 1:0 1:0 1:0 1:0 1:2 2:9 1:3 1:0 1:0 1:0 1:0 1:0 1:0 1:0 1:4 2:9 1:1 0 1:1 2:9 1:1 0 0 0 1:1 2:9 1:1 
1:1 2:9 2:9 2:9 2:9 2:9 2:9 2:9 2:9 2:9 1:1 0 0 0 0 0 0 0 1:1 2:9 1:1 0 1:1 2:9 1:1 0 0 0 1:1 2:9 1:1 
1:1 2:9 1:3 1:0 1:0 1:0 1:0 1:0 1:4 2:9 1:1 0 0 0 0 0 0 0 1:1 2:9 1:1 0 1:1 2:9 1:1 0 0 0 1:1 2:9 1:1 
1:1 2:9 1:5 1:0 1:0 1:0 1:0 1:0 1:2 2:9 1:1 0 0 0 0 0 0 0 1:1 2:9 1:5 1:0 1:2 2:9 1:5 1:0 1:0 1:0 1:2 2:9 1:1 
1:1 2:0 2:9 2:9 2:9 2:9 2:9 2:9 2:9 2:1 1:1 0 0 0 0 0 0 0 1:1 2:1 2:9 2:9 2:9 2:9 2:9 2:9 2:9 2:9 2:9 2:0 1:1 
1:5 1:0 1:0 1:0 1:0 1:0 1:0 1:0 1:0 1:0 1:2 0 0 0 0 0 0 0 1:5 1:0 1:0 1:0 1:0 1:0 1:0 1:0 1:0 1:0 1:0 1:0 1:2 
