1:3 1:0 1:0 1:0 1:0 1:0 1:0 1:8 1:0 1:0 1:0 1:0 1:0 1:0 1:0 1:0 1:0 1:0 1:0 1:0 1:0 1:0 1:0 1:0 1:0 1:0 1:0 1:0 1:0 1:0 1:4 
1:1 3:2 2:0:0 2:0:0 2:0:0 2:0:0 2:0:0 1:1 1:3 1:4 2:1:0 2:0:0 2:0:0 2:0:0 2:0:0 2:0:0 2:0:0 2:0:0 2:2:0 2:0:0 2:0:0 2:0:0 2:0:0 2:0:0 2:0:0 2:0:0 2:0:0 2:0:0 2:0:0 2:1:0 1:1 
1:1 2:0:0 1:3 1:0 1:0 1:4 2:0:0 1:1 1:1 1:1 2:0:0 1:3 1:0 1:0 1:0 1:0 1:0 1:4 2:0:0 1:3 1:0 1:0 1:0 1:0 1:0 1:0 1:0 1:0 1:4 2:0:0 1:1 
1:1 2:0:0 1:1 0 0 1:1 2:0:0 1:12 1:12 1:1 2:0:0 1:1 0 0 0 0 0 1:1 2:0:0 1:1 0 0 0 0 0 0 0 0 1:1 2:0:0 1:1 
1:1 2:0:0 1:1 0 0 1:1 2:0:0 2:0:0 2:0:0 1:12 2:0:0 1:1 0 0 0 0 0 1:1 2:0:0 1:1 0 0 0 0 0 0 0 0 1:1 2:0:0 1:1 
1:1 2:0:0 1:1 0 0 1:5 1:0 1:4 2:0:0 2:0:0 2:0:0 1:1 0 0 0 0 0 1:1 2:0:0 1:1 0 0 0 0 0 0 0 0 1:1 2:0:0 1:1 
1:1 2:0:0 1:5 1:4 0 0 0 1:1 2:0:0 1:10 2:0:0 1:1 0 0 0 0 0 1:1 2:0:0 1:1 0 0 0 0 0 0 0 0 1:1 2:0:0 1:1 
1:1 2:0:0 2:0:0 1:1 0 0 0 1:1 2:0:0 1:1 2:0:0 1:1 0 0 0 0 0 1:1 2:0:0 1:1 0 0 0 0 0 0 0 0 1:1 2:0:0 1:1 
1:7 1:11 2:0:0 1:1 0 0 0 1:1 2:0:0 1:1 2:0:0 1:1 0 0 0 0 0 1:1 2:0:0 1:1 0 0 0 0 0 0 0 0 1:1 2:0:0 1:1 
1:1 2:1:0 2:0:0 1:1 0 0 0 1:1 2:0:0 1:1 2:0:0 1:1 0 0 0 0 0 1:1 2:0:0 1:1 0 0 0 0 0 0 0 0 1:1 2:0:0 1:1 
1:1 2:0:0 1:13 1:9 0 0 0 1:1 2:0:0 1:1 2:0:0 1:1 0 0 0 0 0 1:1 2:0:0 1:1 0 0 0 0 0 0 0 0 1:1 2:0:0 1:1 
1:1 2:0:0 1:3 1:9 0 0 0 1:1 2:0:0 1:1 2:0:0 1:1 0 0 0 0 0 1:1 2:0:0 1:1 0 0 0 1:3 1:0 1:4 0 0 1:12 2:0:0 1:1 
1:1 2:0:0 1:1 1:1 0 0 0 1:12 2:0:0 1:12 2:0:0 1:5 1:0 1:0 1:0 1:0 1:11 1:12 2:0:0 1:5 1:0 1:0 1:0 1:2 1:13 1:6 1:0 1:0 1:4 2:1:0 1:1 
1:1 2:0:0 1:1 1:1 0 0 0 1:10 2:1:0 2:0:0 2:0:0 2:0:0 2:0:0 2:0:0 2:0:0 2:0:0 2:0:0 2:0:0 2:1:0 2:0:0 2:0:0 2:0:0 2:0:0 2:0:0 2:0:0 2:0:0 2:0:0 2:2:0 1:1 2:0:0 1:1 
1:1 2:0:0 1:1 1:5 1:0 1:0 1:0 1:6 1:0 1:4 2:0:0 1:3 1:0 1:0 1:0 1:4 0 1:3 1:0 1:0 1:0 1:0 1:0 1:4 2:0:0 1:3 1:0 1:11 1:1 2:0:0 1:1 
1:1 2:0:0 1:1 0 0 0 0 0 0 1:1 2:0:0 1:1 0 0 1:3 1:2 4:3 1:5 1:4 0 0 0 0 1:1 2:0:0 1:1 0 0 1:1 2:0:0 1:1 
1:1 2:0:0 1:1 0 0 0 0 0 0 1:1 2:0:0 1:1 0 0 1:1 4:0 4:1 4:2 1:1 0 0 0 0 1:1 2:0:0 1:1 0 0 1:1 2:0:0 1:1 
1:1 2:0:0 1:1 0 0 0 0 0 0 1:1 2:0:0 1:1 0 0 1:5 1:0 1:0 1:0 1:2 0 0 0 0 1:1 2:0:0 1:1 0 0 1:1 2:0:0 1:1 
1:1 2:0:0 1:1 0 0 0 0 0 0 1:1 2:0:0 1:1 0 0 0 0 0 0 0 0 0 0 0 1:1 2:0:0 1:1 0 0 1:1 2:0:0 1:1 
1:1 2:0:0 1:1 0 0 0 0 0 0 1:1 2:0:0 1:1 0 0 0 0 0 0 0 0 0 0 0 1:1 2:0:0 1:1 0 0 1:1 2:0:0 1:1 
1:1 2:0:0 1:1 0 0 0 0 0 0 1:1 2:0:0 1:1 0 0 0 0 0 0 0 0 0 0 0 1:1 2:0:0 1:1 0 0 1:1 2:0:0 1:1 
1:1 2:0:0 1:1 0 0 0 0 0 0 1:1 2:0:0 1:1 0 0 0 0 0 0 0 0 0 0 0 1:1 2:0:0 1:1 0 0 1:1 2:0:0 1:1 
1:1 2:0:0 1:5 1:0 1:0 1:0 1:0 1:0 1:0 1:2 2:0:0 1:1 0 0 0 0 0 0 0 0 0 0 0 1:1 2:0:0 1:1 0 0 1:1 2:0:0 1:1 
1:1 2:1:0 2:0:0 2:0:0 2:0:0 2:0:0 2:0:0 2:0:0 2:0:0 2:0:0 2:1:0 1:1 0 0 0 0 0 0 0 0 0 0 0 1:1 2:0:0 1:1 0 0 1:1 2:0:0 1:1 
1:5 1:0 1:0 1:0 1:0 1:0 1:0 1:0 1:0 1:4 2:0:0 1:1 0 0 0 0 0 0 0 0 0 0 0 1:1 2:0:0 1:1 0 0 1:1 2:0:0 1:1 
0 0 0 0 0 0 0 0 0 1:1 2:0:0 1:1 0 0 0 0 0 0 0 0 0 0 0 1:1 2:0:0 1:1 0 0 1:1 2:0:0 1:1 
0 0 0 0 0 0 0 0 0 1:1 2:0:0 1:1 0 0 0 0 0 0 0 0 0 0 0 1:1 2:0:0 1:1 0 0 1:1 2:0:0 1:1 
0 0 0 0 0 0 0 0 0 1:1 2:0:0 1:5 1:0 1:0 1:0 1:0 1:4 0 0 0 0 1:3 1:0 1:2 2:0:0 1:5 1:0 1:0 1:2 2:0:0 1:1 
0 0 0 0 0 0 0 0 0 1:1 2:0:0 2:0:0 2:0:0 2:0:0 2:0:0 2:0:0 1:5 1:0 1:0 1:0 1:0 1:2 2:0:0 2:0:0 2:0:0 2:0:0 2:0:0 2:0:0 2:0:0 2:1:0 1:1 
0 0 0 0 0 0 0 0 0 1:5 1:0 1:0 1:0 1:0 1:4 2:2:0 2:0:0 2:0:0 2:0:0 2:0:0 2:0:0 2:0:0 2:0:0 1:3 1:0 1:0 1:0 1:0 1:0 1:0 1:2 
0 0 0 0 0 0 0 0 0 0 0 0 0 0 1:5 1:0 1:0 1:0 1:0 1:0 1:0 1:0 1:0 1:2 0 0 0 0 0 0 0 
